type octile
height 100
width 100
map
TTTTTTTTTTTTTTTTTTTTTTTTTTTTTTTTTTTTTTTTTTTTTTTTTTTTTTTTTTTTTTTTTTTTTTTTTTTTTTTTTTTTTTTTTTTTTTTTTTTT
T....T......T..TTT..T......T...T....T.TT.T...T.e........T..T....T.T..TT..T.......TT.T.........T....T
T....T..TT...T....TTT...T..TT.TT.T...T.TT.T......T...T.TT.T....T...T.T.........TT....T...T......T..T
T.........T.T.T.T...TT...TT..TTT....TT.T.......T.T..T.T..............T...........T.T..T.T.......TT.T
T..T...T..T.T..TTT.T...............T.....T.TT....T...T...T.......TT........T.T.....TT........T.....T
T.T...T..T.....TTT.T..T....T......T....T.T.T......T..T..........TT.T.....TT........T...T....TT.TT..T
T..T.T.T.TT.......T.......T.TT.T..T...T..........T....T.....T...T..TTT....TT.T....T.T.....T...T....T
T...T....T...T...TT...T......T.........T...T....TT.T....TT.T..T...........T........TT..T.TT...T..T.T
T..TTTTT.T.T..TT......T.TT..T......T...T.T.....T..T.T......TT...T.........T.T...T.........T.TT.T...T
T...T.....T.T..T..T.TT.TTTTT.T...TTT..T......T......T............T..T....T....T.......T.T..........T
T............T...TT..TT....T.T..TTTT.....T..T...T.TT.....T..TT...........T.........T..T......T...T.T
T..TT....T.......T.......T.......T..T.T.T....T.T..T...T.T..T..........T....TT...TT...T.......T.TT..T
T..TT.T..TT..TT.TTT.TT..................T......T.........T...TTT....T.T.....T........T.....T.......T
T.......T.......TT.T....T.T..T.....T....TT....TTT..T....T........T.T.......T.T.T...T..TT......T..T.T
T.TTT....T.T..T...T............T..T........TT....T.....T.T..TTT.........T.T...T.T.....TTT.T...T....T
T....T.T......TTT..T.....T............T.TT.T..T.T.........TT.........T.T.T........T..T..........T..T
TT..T.........T.TT....T.......T.....T.......T..........T......T.......T.....T.T.T.T....T.T.....TT..T
T...T.T...T..........T...T.T...TT.T.T..T.T..T..T......TTT....T.....T......T..T..TT...T...T...T.....T
TT....T.T.T..TTT...TT......T....T....TT.TT..T.T.....TT....T......T.T..TTTT..T......T...TT.....T..T.T
TT...TT...TT...T...T.......T.T..............T...T........T..........T.TT......TTT...TT......T.....TT
T..T.....TT...T.....T..T.T...T.TTTT.......T.......TT..T.T.....T.........TT.....T.T......T.T........T
TT.T...TT.TT....TT.TT.TT.T........TT.T....T..T............T.T.........T...T..TT.....T.T..TTTT.T....T
T....T.......TT..........T..T......TT....TT....T.T.T.T..T.T.T...TT...T.T........TT.T.TT..T..T......T
T...TT..T..........T....TTT.......T.........T...........T..TT.....TT..T....T........T.TT.........TTT
T.T.........T......T...TT..T.......TT..T........T.T....T........T.......TT...T.T...T...T.T.....TT.TT
T..T...........T.T..T.....T.....T..T.......TT.T.......T....TT.T...T.T...T.....................T...TT
T..T.T..T.T...T.T......TT..T....T...........T...............T...TT.........T.T.....T.....T..T......T
T...T..T...............T.T......TTT.......TT....T..T........T...TT..TT.T.....T...T........T........T
TT..............TT.T.T............T.......T........TT.TT...T.TT...............TT...T.TT...T.T..T.T.T
TTTT..T.T.T.T....T.......T.T.T.T.TT.....T...T.T..TT.T......T...T..T.T.....T..T........T.....T...T.TT
T.......T.........TTT.T.TT....T......T..T....TTTT.T.....T..T....T..T..T.............T..TTT...TTTT..T
T...T.....T...T.TT.....TTT.T.TTT....T..T..T.T...T..T..T.......T...T..T.T......T..TT..T..T...T.....TT
TTT.....TT.TTT.....TTT.TT.T.T.....T.TT.......T.T...............T.T.TT..T....TT.T.....T.T........TT.T
T........T..T..T...T........TTT....TTT....TTT.T.T.......T........T.............T.TT........T...TT.TT
T....T.........T.......TT........TT...........TT.....T.T....T.T..........T.....TTT.T........T......T
T....T.TT....T.T..T..T.T....TT....TTT.........T...............TT.TT.T...T......T.......T.T.T.......T
T..T..TTT......T.....T.T..T.T.....TT..T.T......TTTTTT.T..T..T......T.....TT...T..TT.......T......T.T
TTTT..TTT.TT......T..............T...T...T...T.T.T..T.....T..T.T.TT......T.T............T...T...T..T
T.TT..T..T......TT.T..........T.T..............T.T..T....TT........T.T...........T.........T..T.T.TT
T....T...T..T.T.T.T...TT.T...T.....T........TT.TT.T.....TT.TTT.......TT.......TT....T...T....T.T...T
TT.....TT.T...T..................T.......T.T.TT..T.T......TT......TT.........TT........T....T......T
T.T...T.T....T..T......TT........T....TT...TTT........TT...T.T....TT........T...TTT...TT.TT..T.....T
T.........TT..T.......T.TT.T..T.T..TT......TTT.....T.T................T.TT.....T.T......TT.TT.TT...T
T...TT.T............TTTTTTTT...T...T....TT..T..T...........T.T.............TT....TT..T.TT.........TT
TTT...T..T.........T.T......TT..........T.T..TT.....T....T......T.T.T..T....T.T...TT.T..T...T..T...T
T.......T......T.T....T.T...T...T.T.T.....T.T..T.......T...T..TTTTT.TT..T.....T....T.....T......T..T
T..T..T..T....T.........T..TTT........T....T....T...T.TT.....TT..T..T...TTT.T..T.T......T..T.....T.T
TT.T........T....T.T.....TT..T.......T.T...T........T....T..TT......T.T.....T..T..T..T..T.....T...TT
T...T..T.T...T.TT...T..T...T......T.....T..TT....T...T.TT..TT..T........T......TT...T.T..TTT.T.T..TT
T..........TT.TT..T...T......T.............T...T.....TT.T..T.T...T.....T..T.T......T....T...T.....TT
T......T..TT..........TT.T...T...TT...T...TT...T.....TT.....T....T.T..T...T.........T.T.T........TTT
T...T.T.....T...T.......T.T.TT..TTT.....TT......T..TT.......................T..TT...T......TT.T...TT
T..T...T..T....T....T.TT.T.T....T....T.T.TT.TT.T.T....T...........T.TT.....T....T.TT.T.T....TT.T...T
TT....T..T..............T.....TTT..T.T..............TT...T.T....T...T...T..TTT.....T...T.T..TT...T.T
T..T...TTT.TTT..T....T....TT..T.T....T.T..T....TT.TT.TT.T....T..TT...T..T.T..........T...T......T..T
T..........TT......T.........T.........T......T..T.....T..T.T....TT.....T.T..T.T.T..T...T.T......T.T
T..T.T...T......T...T..T..TT....T......T...T....T.....T.TT...T...TT......T........TTTTT.....TT.T...T
T......TT.....T........T...TTT..T..TTTT...T...T......TT.TT.T....T.TT....TT...TT..T.............T...T
T..TTT...T.TT..T.TT.T......T....T....T.TT...s.T...T.....T........T...T......T..TT..TT.T....T......TT
TT....T.T.T..TTT...TT......T....T....TT.TT..T.T.....TT....T......T.T..TTTT..T......T...TT.....T..T.T
TT...TT...TT...T...T.......T.T..............T...T........T..........T.TT......TTT...TT......T.....TT
T..T.....TT...T.....T..T.T...T.TTTT.......T.......TT..T.T.....T.........TT.....T.T......T.T........T
TT.T...TT.TT....TT.TT.TT.T........TT.T....T..T............T.T.........T...T..TT.....T.T..TTTT.T....T
T....T.......TT..........T..T......TT....TT....T.T.T.T..T.T.T...TT...T.T........TT.T.TT..T..T......T
T...TT..T..........T....TTT.......T.........T...........T..TT.....TT..T....T........T.TT.........TTT
T.T.........T......T...TT..T.......TT..T........T.T....T........T.......TT...T.T...T...T.T.....TT.TT
T..T...........T.T..T.....T.....T..T.......TT.T.......T....TT.T...T.T...T.....................T...TT
T..T.T..T.T...T.T......TT..T....T...........T...............T...TT.........T.T.....T.....T..T......T
T...T..T...............T.T......TTT.......TT....T..T........T...TT..TT.T.....T...T........T........T
TT..............TT.T.T............T.......T........TT.TT...T.TT...............TT...T.TT...T.T..T.T.T
TTTT..T.T.T.T....T.......T.T.T.T.TT.....T...T.T..TT.T......T...T..T.T.....T..T........T.....T...T.TT
T.......T.........TTT.T.TT....T......T..T....TTTT.T.....T..T....T..T..T.............T..TTT...TTTT..T
T...T.....T...T.TT.....TTT.T.TTT....T..T..T.T...T..T..T.......T...T..T.T......T..TT..T..T...T.....TT
TTT.....TT.TTT.....TTT.TT.T.T.....T.TT.......T.T...............T.T.TT..T....TT.T.....T.T........TT.T
T........T..T..T...T........TTT....TTT....TTT.T.T.......T........T.............T.TT........T...TT.TT
T....T.........T.......TT........TT...........TT.....T.T....T.T..........T.....TTT.T........T......T
T....T.TT....T.T..T..T.T....TT....TTT.........T...............TT.TT.T...T......T.......T.T.T.......T
T..T..TTT......T.....T.T..T.T.....TT..T.T......TTTTTT.T..T..T......T.....TT...T..TT.......T......T.T
TTTT..TTT.TT......T..............T...T...T...T.T.T..T.....T..T.T.TT......T.T............T...T...T..T
T.TT..T..T......TT.T..........T.T..............T.T..T....TT........T.T...........T.........T..T.T.TT
T....T...T..T.T.T.T...TT.T...T.....T........TT.TT.T.....TT.TTT.......TT.......TT....T...T....T.T...T
TT.....TT.T...T..................T.......T.T.TT..T.T......TT......TT.........TT........T....T......T
T.T...T.T....T..T......TT........T....TT...TTT........TT...T.T....TT........T...TTT...TT.TT..T.....T
T.........TT..T.......T.TT.T..T.T..TT......TTT.....T.T................T.TT.....T.T......TT.TT.TT...T
T...TT.T............TTTTTTTT...T...T....TT..T..T...........T.T.............TT....TT..T.TT.........TT
TTT...T..T.........T.T......TT..........T.T..TT.....T....T......T.T.T..T....T.T...TT.T..T...T..T...T
T.......T......T.T....T.T...T...T.T.T.....T.T..T.......T...T..TTTTT.TT..T.....T....T.....T......T..T
TT.T........T....T.T.....TT..T.......T.T...T........T....T..TT......T.T.....T..T..T..T..T.....T...TT
T...T..T.T...T.TT...T..T...T......T.....T..TT....T...T.TT..TT..T........T......TT...T.T..TTT.T.T..TT
T..........TT.TT..T...T......T.............T...T.....TT.T..T.T...T.....T..T.T......T....T...T.....TT
T......T..TT..........TT.T...T...TT...T...TT...T.....TT.....T....T.T..T...T.........T.T.T........TTT
T...T.T.....T...T.......T.T.TT..TTT.....TT......T..TT.......................T..TT...T......TT.T...TT
T..T...T..T....T....T.TT.T.T....T....T.T.TT.TT.T.T....T...........T.TT.....T....T.TT.T.T....TT.T...T
TT....T..T..............T.....TTT..T.T..............TT...T.T....T...T...T..TTT.....T...T.T..TT...T.T
T..T...TTT.TTT..T....T....TT..T.T....T.T..T....TT.TT.TT.T....T..TT...T..T.T..........T...T......T..T
T..........TT......T.........T.........T......T..T.....T..T.T....TT.....T.T..T.T.T..T...T.T......T.T
T..T.T...T......T...T..T..TT....T......T...T....T.....T.TT...T...TT......T........TTTTT.....TT.T...T
T......TT.....T........T...TTT..T..TTTT...T...T......TT.TT.T....T.TT....TT...TT..T.............T...T
T..TTT...T.TT..T.TT.T......T....T....T.TT...s.T...T.....T........T...T......T..TT..TT.T....T......TT
TTTTTTTTTTTTTTTTTTTTTTTTTTTTTTTTTTTTTTTTTTTTTTTTTTTTTTTTTTTTTTTTTTTTTTTTTTTTTTTTTTTTTTTTTTTTTTTTTTTT