type octile
height 60
width 60
map
TTTTTTTTTTTTTTTTTTTTTTTTTTTTTTTTTTTTTTTTTTTTTTTTTTTTTTTTTTTT
TT.........T...e..T.T...T.........TT...T...T.T...T........TT
T...T.T..TT....T.....T......TT.........T................T..T
T.T......T.T..TT...TT...T..T.T.......TT.....TTT....T..TT..TT
T............T...TTTTT.........T.T.TT.TT......TTTTT...T...TT
TT..T..T...T..................TT.....T.......TTT..T.....T..T
TTTT.....TT.....TT...T.T.......TT....T..TT.TT....T....T...TT
T.....T......TT..........T......T...T...T......T...T.TT....T
TT....TT....T......T.T...T.T...T....TT...T..TTT..TT.T..T...T
TTT.TT..T.T..........T.....T...T.T............TT...T....T..T
TT.....TT..T.T.T.T.......T...T............T.....T....T.....T
T.T.TT.TT....T..T....T........T....TT.T....T.....T..T......T
T..T.......T....T.T...T.....TT..TTT.T..T..T.......T....T..TT
T.....T.T...T.T..T..T..T........T...TT........TT...TT..T...T
T...T.T....T.....TT..T.T...T.......T.TTT.......T...T..T....T
T..T.TT.....T.....T.......T.....T.T.T...T...TT...TT........T
T.....T.T....TTT....TT...TT.T.....T.T..T...TT.....T...TT...T
TT.............TT.....T.T....T...T....T.......T........T...T
T...T...T.....T...T.......T...TTT.....T..........T....T..T.T
T.TTTT........TTTT..TT...........T.T..........T.TT.T.......T
TT...T.............T........T..T.......TT....T...TTT..T..T.T
T...T...T..T.......T.....T....T.....T..TTT.TT.T.T.....TTT..T
TT......T.T.TT..TT.TT..T.......T...TT.T....TT.....T........T
TT.T..........T.....TTT....T.....T...T........TT.T..T..TT.TT
TTT..T...........T................T....T......T...T.T....TTT
TTT....T...T....T...TT..TT.......T.T..T.T......T....T......T
T...T...T....TT.T..T....T.T.T..T...T....TT.T.T.T.....TTT..TT
T..T..T...T...T.....TTT.T........T...T.....T......TT.....T.T
T.T..T..T..........T..T....TT....TTT......T..T.TT....T.....T
TTTTT.T.T............T......TTT.......TT...T.....TT...T....T
TT.T..T..T........T.T..T...TT.....T...T...T.TT..T.TTT......T
T....TT.T.T.........T..........T.T..T.TTT.T.T.T....TT.....TT
T.......T...T.....T..T......TT.T..........T........TTT.....T
TTTTT..T...........TTT......T..T.....TTT...TTT..TT......T..T
T....T.T..T.TT...T...........T.T..TT.........T.T.TT....TT..T
T.T.T....T.T..T..T.T.T.....TT............T.T.T.....T.....T.T
T..T....TT.T...T.T....T...T....TTT......TT...T..TT.T..T.T..T
T..T........T....TTT......T.....TTT....T......T....TT....T.T
T...T.TT..T.T...TT....T..........T..T..TT.T..T.T.T........TT
TTTT......T..T..T.T.T.TT.........T.T.T...........T....TT...T
TT............T..T....T.....T.......T........T..........T..T
T....T..TT.T.T...T.TT.T........TTT.T.T.TT......TT....T.....T
T.......T.T....T............T...T.................T........T
TT....TTT..........T.T...T...T.T....TTT.TT............T....T
T.T..T....T......T..T.......T.....T............T....TT.....T
T..T..T.....T......T..T..TTTT....T........T....T.T..T......T
T.T...T...TT.........T.T...TT.....T......TTT.T........T....T
T.T........TT.T..T.........T.T.......T.T....T..........T...T
T.....T.....TT..T..TT...T............TT...TT...T...T.......T
T.TT...T.T....T..TT........T...T..T.......T...T..T...TT...TT
T..T....T......T...T...T...TT......TT...T....T..T.TT.T...T.T
T.T....T.....TT....T..T.T.......T..T.....T...TTT...T.TT....T
T....T...T....T..T..T..................T....TT......T......T
T.T....T.TT..T....T.....T.T............TTT...T..T....T....sT
T........TT..TTT........T........T...T.............T...T.TTT
T.....T..T..T.....T.T....T.T..T...T..T......T........T..T.TT
TT...TT..TTT......T.....T..T..T.T.TTT.T...T....T......TTT..T
T............T.TT......T.......TT..T.......T...T....T...T..T
T...T.....T.............TT.T..TT.T.T....T.....T.....T....T.T
TTTTTTTTTTTTTTTTTTTTTTTTTTTTTTTTTTTTTTTTTTTTTTTTTTTTTTTTTTTT